1111111111111111111111111111111111111111111111111111111111111111111111111111111
1P00000000000000000000000000000000000000000000000000000000000000000000000000001
11111111111111111111111111111111111111111111111111111111111111111111111111110C1
100000000000000000000000000000C00000000000000000000000C000000000000000000000001
1001111111111111111111111111111111111111111111111111111111111111111111111111111
1CCC000000000000000000000000000000C000000000000000C0000000000000000000C00000001
1111111111111111111111111111111111111111111111111111111111111111111111111111C01
1C000000000000000000000000000000000000000000CCCC00000000000000000000000000000C1
1001111111111111111111111111111111111111111111111111111111111111111111111111111
100000000000000000CC0000000000000000000000000C0000000000000000000000000C0000001
1111111111111111111111111111111111111111111111111111111111111111111111111111001
1E01000C00001000001000C01000000C01000C01000001111C00000000C0100000100CC000C1001
10C1001001001001001001001001001001001001001C01000C00001000001CC00010C0000C01001
1001001001001001001001001001001001001001001001000000001000001000001001111111001
10000010000CC001C0000100000100C0000010000010000000000C1000100011100000000000001
1111111111111111111111111111111111111111111111111111111111111111111111111111111