111111111
1C0000011
10CE00P01
100000000
111111111