1111111111111
1C010000000C01
10000111110001
1P0011E0000001
1111111111111